  10 10
  0 2
  9 7
  3 14  5 11 10 10  2 10 10  6
  5  3  8 10 10 10  8 10  6  5
  5  5  3 10 10 10 10  6  5  5
  5  5 13  3 10  6  7  5 13  5
  5  1 10  4  7  9  4  1 10  4
  5  5  7  5  1 14  5  5  7  5
  5  5  5 13  5  3 12  5  5  5
  5  5  9 10  4  5 11 12  5  5
  5  9 10 14  5  9 10  2 12  5
  9 10 10 10  8 10 14  5 11 12